NO textures/red_wall.xpm
SO textures/green_wall.xpm
WE textures/blue_wall.xpm
EA textures/wall.xpm

C 170,213,236
F 231,227,18


111111111111111111111
101000001000000000001
101010101011111110001
100010100N100000100u1
111110101111101011101
1000001010 0101000001
101111101011101111111
111111111111111111111